######I########
### ##  ##   ##
# #  ##    # ##
# ## ### ### ##
#      ###   ##
### ## ##### ##
##  ##       ##
###O###########