######S########
###.##..##...##
#.#..##....#.##
#.##.###.###.##
#......###...##
###.##.#####.##
##..##.......##
###E###########