#################################E###
###....#.....#......###...#...#...#.#
#...##...###...####.....#..##.#.##..#
#.#########.###....##.####.##.#.#..##
#.............##.######..#......#...#
#####.#####.#............##########.#
#S..........###.#.#.##..............#
#####################################